You're a rookie cop whos been assigned to raid a criminals stash house for evidence of their crimes. You're looking for A Bomb they built, Volatile chemicals they were planning to mix, a Fake ID they were going to use to escape, and a bag of Cocaine they were stashing. Find all the evidence and bring the criminal to justice!

BEAT COP
An Interactive Fiction by Logan Williamson
Release 1 / Serial number 251008 / Inform 7 v10.1.2 / D

Front Lawn
No point standing out here, time to kick the door in and search the building for evidence!

You can see main door and a Fake Rock (closed) here.

>e
You can't go that way.

>w
(first opening main door)

Entrance
You can see main door here.

>s
Bathroom
Take a shit and leave

You can see a toilet that can be sat on here.

>sit on toilet
That's not something you can sit down on.

* * *

>w
(first opening main door)

Entrance
You can see main door here.

>w
Hall 1
Another room of gateways to other rooms, the Kitchen is to the North with a garage to the South and more hallway ahead to the West

>w
Hall 2
The room of gateways to other rooms, to the North is the Livingroom with a Bedroom to the West and more hallway behind you to the East

>n
Livingroom
There's not much here apart from a couch and countless empty beer bottles. There's two sets of stairs, one going Down to the Basement and one going Up to the Attic

>down
Basement

>attack convict
You can't see any such thing.

>attack Convict
You can't see any such thing.

>attack
What do you want to attack?

>attack convict
You can't see any such thing.

* * *

You're a rookie cop whos been assigned to raid a criminals stash house for evidence of their crimes. You're looking for A Bomb they built, Volatile chemicals they were planning to mix, a Fake ID they were going to use to escape, and a bag of Cocaine they were stashing. Find all the evidence and bring the criminal to justice!

BEAT COP
An Interactive Fiction by Logan Williamson
Release 1 / Serial number 251008 / Inform 7 v10.1.2 / D

Front Lawn
No point standing out here, time to kick the door in and search the building for evidence!

You can see main door and a Fake Rock (closed) here.

>examine Fake Rock
It seems like a plastic rock made for storing a spare key
A strange ticking noise fills the air

>lift Fake Rock
That's not a verb I recognise.

>Take Fake Rock
That's fixed in place.

A strange ticking noise fills the air

>Move Fake Rock
It is fixed in place.

A strange ticking noise fills the air

>Kick In Main Door
I only understood you as far as wanting to kick inside.

>Kick Door
The door swings back instantly killing you

    *** G A M E  O V E R. ***

Would you like to RESTART, RESTORE a saved game, QUIT or UNDO the last command?

>Restart
You're a rookie cop whos been assigned to raid a criminals stash house for evidence of their crimes. You're looking for A Bomb they built, Volatile chemicals they were planning to mix, a Fake ID they were going to use to escape, and a bag of Cocaine they were stashing. Find all the evidence and bring the criminal to justice!

BEAT COP
An Interactive Fiction by Logan Williamson
Release 1 / Serial number 251001 / Inform 7 v10.1.2 / D

Front Lawn
No point standing out here, time to kick the door in and search the building for evidence!

You can see main door and a Fake Rock (closed) here.

>Fake Rock
That's not a verb I recognise.

>Examine Fake Rock
It seems like a plastic rock made for storing a spare key
A strange ticking noise fills the air

>Eat Fake Rock
That's plainly inedible.

A strange ticking noise fills the air

>Examine ticking noise
You can't see any such thing.

>Kick Fake Rock
The Fake Rock is not something you can kick.

A strange ticking noise fills the air

* * *

You're a rookie cop whos been assigned to raid a criminals stash house for evidence of their crimes. You're looking for A Bomb they built, Volatile chemicals they were planning to mix, a Fake ID they were going to use to escape, and a bag of Cocaine they were stashing. Find all the evidence and bring the criminal to justice!

BEAT COP
An Interactive Fiction by Logan Williamson
Release 1 / Serial number 251008 / Inform 7 v10.1.2 / D

Front Lawn
No point standing out here, time to kick the door in and search the building for evidence!

You can see main door and a Fake Rock (closed) here.

>hop
You jump on the spot.

>hop
You jump on the spot.

>hop
You jump on the spot.

    *** The ground shakes as the house explodes into a mess of splinters and debris, the blast kills you instantly. now there can't be any justice! 
 G A M E  O V E R ***

Would you like to RESTART, RESTORE a saved game, QUIT or UNDO the last command?

* * *

You're a rookie cop whos been assigned to raid a criminals stash house for evidence of their crimes. You're looking for A Bomb they built, Volatile chemicals they were planning to mix, a Fake ID they were going to use to escape, and a bag of Cocaine they were stashing. Find all the evidence and bring the criminal to justice!

BEAT COP
An Interactive Fiction by Logan Williamson
Release 1 / Serial number 251008 / Inform 7 v10.1.2 / D

Front Lawn
No point standing out here, time to kick the door in and search the building for evidence!

You can see main door and a Fake Rock (closed) here.

>jump
You jump on the spot.

A strange ticking noise fills the air

* * *

You're a rookie cop whos been assigned to raid a criminals stash house for evidence of their crimes. You're looking for A Bomb they built, Volatile chemicals they were planning to mix, a Fake ID they were going to use to escape, and a bag of Cocaine they were stashing. Find all the evidence and bring the criminal to justice!

BEAT COP
An Interactive Fiction by Logan Williamson
Release 1 / Serial number 251008 / Inform 7 v10.1.2 / D

Front Lawn
No point standing out here, time to kick the door in and search the building for evidence!

You can see main door and a Fake Rock (closed) here.

>kick
What do you want to kick?

>kick door
You can't see any such thing.

* * *

You're a rookie cop whos been assigned to raid a criminals stash house for evidence of their crimes. You're looking for A Bomb they built, Volatile chemicals they were planning to mix, a Fake ID they were going to use to escape, and a bag of Cocaine they were stashing. Find all the evidence and bring the criminal to justice!

BEAT COP
An Interactive Fiction by Logan Williamson
Release 1 / Serial number 251008 / Inform 7 v10.1.2 / D

Front Lawn
No point standing out here, time to kick the door in and search the building for evidence!

You can see main door and a Fake Rock (closed) here.

>kick door
(main door)
The door swings back instantly killing you

    *** G A M E  O V E R. ***

Would you like to RESTART, RESTORE a saved game, QUIT or UNDO the last command?

>hit door
You can't see any such thing.

>kick
You must supply a noun.

>kick door
I only understood you as far as wanting to kick.

* * *

>kick door
(main door)
The door swings back instantly killing you

    *** G A M E  O V E R. ***

Would you like to RESTART, RESTORE a saved game, QUIT or UNDO the last command?

>restart
You're a rookie cop whos been assigned to raid a criminals stash house for evidence of their crimes. You're looking for a bomb they built, Volatile chemicals they were planning to mix, a Fake ID they were going to use to escape, and a bag of Cocaine they were stashing. Find all the evidence and bring the criminal to justice!

BEAT COP
An Interactive Fiction by Logan Williamson
Release 1 / Serial number 250910 / Inform 7 v10.1.2 / D

Front Lawn
No point standing out here, time to kick the door in and search the building for evidence!

You can see main door and Fake Rock (in which is Door Key) here.

>x rock
In Fake Rock is Door Key.

>take
What do you want to take?

>take key
Taken.

>kick door
(Door Key)
Door Key is not something you can kick.

* * *

>kick door
(main door)
The door swings back instantly killing you

    *** G A M E  O V E R. ***

Would you like to RESTART, RESTORE a saved game, QUIT or UNDO the last command?

>x Front lawn
You can't see any such thing.

>look
Front Lawn
No point standing out here, time to kick the door in and search the building for evidence!

>kick
What do you want to kick?

>kick self
You is not something you can kick.

>kick door
You can't see any such thing.

>kick main door
You can't see any such thing.

* * *

>kick door
(main door)
The door swings back instantly killing you

    *** G A M E  O V E R. ***

Would you like to RESTART, RESTORE a saved game, QUIT or UNDO the last command?

>x front lawn
You can't see any such thing.

* * *

You're a rookie cop whos been assigned to raid a criminals stash house for evidence of their crimes. You're looking for A Bomb they built, Volatile chemicals they were planning to mix, a Fake ID they were going to use to escape, and a bag of Cocaine they were stashing. Find all the evidence and bring the criminal to justice!

BEAT COP
An Interactive Fiction by Logan Williamson
Release 1 / Serial number 251008 / Inform 7 v10.1.2 / D

Front Lawn
No point standing out here, time to kick the door in and search the building for evidence!

You can see main door and a Fake Rock (closed) here.

>look
Front Lawn
No point standing out here, time to kick the door in and search the building for evidence!

You can see a main door here.

>kick main door
The door swings back instantly killing you

    *** G A M E  O V E R. ***

Would you like to RESTART, RESTORE a saved game, QUIT or UNDO the last command?

>restart
You're a rookie cop whos been assigned to raid a criminals stash house for evidence of their crimes. You're looking for a bomb they built, Volatile chemicals they were planning to mix, a Fake ID they were going to use to escape, and a bag of Cocaine they were stashing. Find all the evidence and bring the criminal to justice!

BEAT COP
An Interactive Fiction by Logan Williamson
Release 1 / Serial number 250829 / Inform 7 v10.1.2 / D

Front Lawn
No point standing out here, time to kick the door in and search the building for evidence!

You can see a main door here.

* * *

You're a rookie cop whos been assigned to raid a criminals stash house for evidence of their crimes. You're looking for A Bomb they built, Volatile chemicals they were planning to mix, a Fake ID they were going to use to escape, and a bag of Cocaine they were stashing. Find all the evidence and bring the criminal to justice!

BEAT COP
An Interactive Fiction by Logan Williamson
Release 1 / Serial number 251008 / Inform 7 v10.1.2 / D

Front Lawn
No point standing out here, time to kick the door in and search the building for evidence!

You can see main door and a Fake Rock (closed) here.

>open dooor
You can't see any such thing.

>open door
You open main door.

>e
You can't go that way.

>w
Entrance
You can see main door here.

>w
Hall 1
Another room of gateways to other rooms, the Kitchen is to the North with a garage to the South and more hallway ahead to the West

>n
Kitchen
You can see Volatile chemicals here.

>eat volatile chemicals
That's plainly inedible.

>take volatile chemicals
Taken.

>n
You can't go that way.

>s
Hall 1
Another room of gateways to other rooms, the Kitchen is to the North with a garage to the South and more hallway ahead to the West

>s
Garage
You can see Car here.

>take car
You're not superman dumbass.

>enter car
That's not something you can enter.

>open car
It isn't something you can open.

>touch car
You feel nothing unexpected.

>x car
There's nothing on the car's seats, but there is a trunk that you haven't checked

>open trunk
It isn't something you can open.

>x trunk
strange it was left unlocked, theres an unarmed bomb inside

>take unarmed bomb
You can't see any such thing.

>take bomb
Taken.

>use bomb
That's not a verb I recognise.

>n
Hall 1
Another room of gateways to other rooms, the Kitchen is to the North with a garage to the South and more hallway ahead to the West

>w
Hall 2
The room of gateways to other rooms, to the North is the Livingroom with a Bedroom to the West and more hallway behind you to the East

* * *

>n
Livingroom
There's not much here apart from a couch and countless empty beer bottles. There's two sets of stairs, one going Down to the Basement and one going Up to the Attic

>down
Basement
You can see Convict 1 here.

>fight convict 1
You attack Convict 1, causing 23 points of damage!

Convict 1 attacks you, causing 18 points of damage!

>fight convict 1
You attack Convict 1, causing 33 points of damage!

Convict 1 attacks you, causing 17 points of damage!

>fight convict 1
You attack Convict 1, causing 50 points of damage!

Convict 1 lies on the ground dead

>x
What do you want to examine?

>x convict 1
You can't see any such thing.

>up
Livingroom
There's not much here apart from a couch and countless empty beer bottles. There's two sets of stairs, one going Down to the Basement and one going Up to the Attic

>down
Basement
You can see Convicts Body here.

>take convicts body
Taken.

>up
Livingroom
There's not much here apart from a couch and countless empty beer bottles. There's two sets of stairs, one going Down to the Basement and one going Up to the Attic

>up
Attic
You can see Trunk key here.

* * *

You're a rookie cop whos been assigned to raid a criminals stash house for evidence of their crimes. You're looking for A Bomb they built, Volatile chemicals they were planning to mix, a Fake ID they were going to use to escape, and a bag of Cocaine they were stashing. Find all the evidence and bring the criminal to justice!

BEAT COP
An Interactive Fiction by Logan Williamson
Release 1 / Serial number 251008 / Inform 7 v10.1.2 / D

Front Lawn
No point standing out here, time to kick the door in and search the building for evidence!

You can see main door and a Fake Rock (closed) here.

>open door
It seems to be locked.

>w
(first opening main door)
It seems to be locked.

>e
You can't go that way.

>n
You can't go that way.

>s
You can't go that way.

* * *

You're a rookie cop whos been assigned to raid a criminals stash house for evidence of their crimes. You're looking for A Bomb they built, Volatile chemicals they were planning to mix, a Fake ID they were going to use to escape, and a bag of Cocaine they were stashing. Find all the evidence and bring the criminal to justice!

BEAT COP
An Interactive Fiction by Logan Williamson
Release 1 / Serial number 251008 / Inform 7 v10.1.2 / D

Front Lawn
No point standing out here, time to kick the door in and search the building for evidence!

You can see main door and a Fake Rock (closed) here.

>open fake rock
You open the Fake Rock, revealing Entrance Key.

>take key
Taken.

>unlock main door
(with Entrance Key)
You unlock main door.

>w
(first opening main door)

Entrance
You can see main door here.

* * *

>w
Hall 1
Another room of gateways to other rooms, the Kitchen is to the North with a garage to the South and more hallway ahead to the West

>s
Garage
You can see Car here.

>x car
(Car)
There's nothing on the car's seats, but there is a trunk that you haven't checked

>open trunk
It seems to be locked.

>n
Hall 1
Another room of gateways to other rooms, the Kitchen is to the North with a garage to the South and more hallway ahead to the West

* * *

>n
Livingroom
There's not much here apart from a couch and countless empty beer bottles. There's two sets of stairs, one going Down to the Basement and one going Up to the Attic

>up
Attic
You can see Trunk key here.

>take
(Trunk key)
Taken.

>s
You can't go that way.

>down
Livingroom
There's not much here apart from a couch and countless empty beer bottles. There's two sets of stairs, one going Down to the Basement and one going Up to the Attic

>s
Hall 2
The room of gateways to other rooms, to the North is the Livingroom with a Bedroom to the West and more hallway behind you to the East

>e
Hall 1
Another room of gateways to other rooms, the Kitchen is to the North with a garage to the South and more hallway ahead to the West

>s
Garage
You can see Car here.

>unlock trunk
What do you want to unlock Trunk key with?

>unlock car trunk
What do you want to unlock Car Trunk with?

>use trunk key on car trunk
You can't see any such thing.

>unlock car trunk with trunk key
You unlock Car Trunk.

>x car trunk
You see nothing special about Car Trunk.

>take bomb
You can't see any such thing.

>hop
You jump on the spot.

    *** The ground shakes as the house explodes into a mess of splinters and debris, the blast kills you instantly. now there can't be any justice! 
 G A M E  O V E R ***

Would you like to RESTART, RESTORE a saved game, QUIT or UNDO the last command?

* * *

>x car
(Car)
There's nothing on the car's seats, but there is a trunk that you haven't checked

>x trunk
You see nothing special about Car Trunk.

>open trunk
It seems to be locked.

    *** The ground shakes as the house explodes into a mess of splinters and debris, the blast kills you instantly. now there can't be any justice! 
 G A M E  O V E R ***

Would you like to RESTART, RESTORE a saved game, QUIT or UNDO the last command?

* * *

>take key
Taken.

>w
(first opening main door)
It seems to be locked.

>unlock main door
(with Entrance Key)
You unlock main door.

* * *

>w
(first opening main door)

Entrance
You can see main door here.

>s
You can't go that way.

>w
Hall 1
Another room of gateways to other rooms, the Kitchen is to the North with a garage to the South and more hallway ahead to the West

* * *

>s
Garage
You can see Car here.

>x car
(Car)
There's nothing on the car's seats, but there is a trunk that you haven't checked

    *** The ground shakes as the house explodes into a mess of splinters and debris, the blast kills you instantly. now there can't be any justice! 
 G A M E  O V E R ***

Would you like to RESTART, RESTORE a saved game, QUIT or UNDO the last command?

* * *

You're a rookie cop whos been assigned to raid a criminals stash house for evidence of their crimes. You're looking for A Bomb they built, Volatile chemicals they were planning to mix, a Fake ID they were going to use to escape, and a bag of Cocaine they were stashing. Find all the evidence and bring the criminal to justice!

BEAT COP
An Interactive Fiction by Logan Williamson
Release 1 / Serial number 251008 / Inform 7 v10.1.2 / D

Front Lawn
No point standing out here, time to kick the door in and search the building for evidence!

You can see main door and a Fake Rock (closed) here.

>open rock
You open the Fake Rock, revealing Entrance Key.

A strange ticking noise fills the air

>take
What do you want to take?

* * *

>take
(Trunk key)
Taken.

>down
Livingroom
There's not much here apart from a couch and countless empty beer bottles. There's two sets of stairs, one going Down to the Basement and one going Up to the Attic

* * *

>s
Garage
You can see Car here.

>unlock car trunk
What do you want to unlock Car Trunk with?

>unlock car trunk with trunk key
You unlock Car Trunk.

>open car trunk
You open Car Trunk, revealing a Timebomb.

* * *

>open rock
You open the Fake Rock, revealing Entrance Key.

A strange ticking noise fills the air

>take key
Taken.

A strange ticking noise fills the air

>unlock door
(with Entrance Key)
You unlock main door.

A strange ticking noise fills the air

>w
(first opening main door)

Entrance
The hall lies ahead to the west, the entrance sits behind you to the east

You can see main door here.

A strange ticking noise fills the air

>w
Hall 1
Another room of gateways to other rooms, the Kitchen is to the North with a garage to the South and more hallway ahead to the West

A strange ticking noise fills the air

>n
Kitchen
Hardly stocked and an absolute mess with all manner of bottles and rotting take out leftovers sitting around

You can see Cabinets (closed) and Scratched Tile (closed) here.

A strange ticking noise fills the air

>open scratched tile
You open Scratched Tile, revealing hidden compartment.

A strange ticking noise fills the air

>x hidden compartment
In hidden compartment is Volatile chemicals.

A strange ticking noise fills the air

>take chemicals
Taken.

A strange ticking noise fills the air

* * *

>n
Kitchen
Hardly stocked and an absolute mess with all manner of bottles and rotting take out leftovers sitting around

You can see Cabinets (closed) and Scratched Tile (closed) here.

A strange ticking noise fills the air

>up
You can't go that way.

>s
Hall 1
Another room of gateways to other rooms, the Kitchen is to the North with a garage to the South and more hallway ahead to the West

>w
Hall 2
The room of gateways to other rooms, to the North is the Livingroom with a Bedroom to the West and more hallway behind you to the East

* * *

>s
Garage
You can see Car here.

>x trunk
(Trunk key)
You see nothing special about Trunk key.

>x car trunk
You see nothing special about Car Trunk.

>x car trunk
You see nothing special about Car Trunk.

>open car trunk
It seems to be locked.

>unlock car trunk
What do you want to unlock Car Trunk with?

* * *

>unlock car trunk with trunk key
You unlock Car Trunk.

>open car trunk
You open Car Trunk, revealing a Bomb.

>Take
(Car)
You're not superman dumbass.

>Take Bomb
Taken.

>n
Hall 1
Another room of gateways to other rooms, the Kitchen is to the North with a garage to the South and more hallway ahead to the West

>n
Kitchen
You can see Volatile chemicals here.

>take
(Volatile chemicals)
Taken.

>s
Hall 1
Another room of gateways to other rooms, the Kitchen is to the North with a garage to the South and more hallway ahead to the West

>e
Entrance
You can see main door here.

>e
Front Lawn
No point standing out here, time to kick the door in and search the building for evidence!

You can see main door and a Fake Rock (empty) here.

>w
Entrance
You can see main door here.

* * *

>w
Hall 2
The room of gateways to other rooms, to the North is the Livingroom with a Bedroom to the West and more hallway behind you to the East

>w
Bedroom
It's a bedroom, you're either sleeping or leaving. The bedroom looks to be in shambles with only a Closet, Dresser, and Nightstand being noteworthy enough to search. There's a bathroom to the South with the Closet being to the North

You can see Rifle here.

>s
Bathroom
You have to cover your nose to even remotely stand being in this room, tiles fall off the walls as mold and who knows what else covers the floor

You can see a Toilet here.

>examine toilet tank
In toilet tank is cocaine.

>take
(the Toilet)
why.

>take cocaine
Taken.

>n
Bedroom
It's a bedroom, you're either sleeping or leaving. The bedroom looks to be in shambles with only a Closet, Dresser, and Nightstand being noteworthy enough to search. There's a bathroom to the South with the Closet being to the North

You can see Rifle here.

>e
Hall 2
The room of gateways to other rooms, to the North is the Livingroom with a Bedroom to the West and more hallway behind you to the East

>n
Livingroom
There's not much here apart from a couch and countless empty beer bottles. There's two sets of stairs, one going Down to the Basement and one going Up to the Attic

>down
Basement
You can see Convict here.

>attack
What do you want to attack?

>attack convict
You attack Convict, causing 43 points of damage!

Convict attacks you, causing 30 points of damage!

>attack
What do you want to attack?

>attack convict
You attack Convict, causing 28 points of damage!

Convict attacks you, causing 22 points of damage!

>attack convict
You attack Convict, causing 24 points of damage!

Convict attacks you, causing 28 points of damage!

>attack
What do you want to attack?

>attack convict
You attack Convict, causing 40 points of damage!

Convict lies on the ground dead

>up
Livingroom
There's not much here apart from a couch and countless empty beer bottles. There's two sets of stairs, one going Down to the Basement and one going Up to the Attic

* * *

>down
Basement
You can see Convicts Body here.

>x convict body
You can't see any such thing.

>x convicts body
You see nothing special about Convicts Body.

>x convicts pocket
In Convicts pocket is Fake ID.

>take fake ID
Taken.

    *** You found all the evidence! Now the criminal can face justice. !!YOU WIN!! G A M E  O V E R. ***

Would you like to RESTART, RESTORE a saved game, QUIT or UNDO the last command?

* * *

>w
Hall 1
Another room of gateways to other rooms, the Kitchen is to the North with a garage to the South and more hallway ahead to the West

A strange ticking noise fills the air

>w
Hall 2
The room of gateways to other rooms, to the North is the Livingroom with a Bedroom to the West and more hallway behind you to the East

* * *

>w
Bedroom
It's a bedroom, you're either sleeping or leaving. The bedroom looks to be in shambles with only a Closet, Dresser, and Nightstand being noteworthy enough to search. There's a bathroom to the South with the Closet being to the North

You can see Rifle here.

>n
Closet
you can see Cord 1 is attached to an IED.

You can see Cord 1, Cord 2 and Cardboard Box here.

>pull cord 2
You switch Cord 2 on.

>pull cord 1
It was a trap! The house exploded!

    *** G A M E  O V E R ***

Would you like to RESTART, RESTORE a saved game, QUIT or UNDO the last command?

>undo
Darkness
[Previous turn undone.]

>pull cord 2
The light clicks on, you can see a cardboard box up on a shelf and the other cord attached to an IED

>s
Bedroom
It's a bedroom, you're either sleeping or leaving. The bedroom looks to be in shambles with only a Closet, Dresser, and Nightstand being noteworthy enough to search. There's a bathroom to the South with the Closet being to the North

You can see Rifle here.

>n
Darkness
It is pitch dark, and you can't see a thing.

>pull cord 2
The light clicks on, you can see a cardboard box up on a shelf and the other cord attached to an IED

* * *

>pull cord 2
You switch Cord 2 on.

>pull cord 2
You switch Cord 2 off.

It is now pitch dark in here!

>pull cord 2
You switch Cord 2 on.

Closet
you can see Cord 1 is attached to an IED.

You can see Cord 1, Cord 2 and Cardboard Box here.

>pull cord 2
You switch Cord 2 off.

It is now pitch dark in here!

>x closet
you feel two cords brush against your face.
You can't see any such thing.

>pull cord 2
you feel two cords brush against your face.

you can see a cardboard box up on a shelf and the other cord attached to an IED.

You switch Cord 2 on.

Closet
you can see a cardboard box up on a shelf and Cord 1 attached to an IED.

You can see Cord 1, Cord 2 and Cardboard Box here.

* * *

>w
(first opening main door)

Entrance
The hall lies ahead to the west, the entrance sits behind you to the east

You can see main door here.

A strange ticking noise fills the air

>ww
That's not a verb I recognise.

>n
You can't go that way.

>w
Hall 1
Another room of gateways to other rooms, the Kitchen is to the North with a garage to the South and more hallway ahead to the West

>n
Kitchen
You can see Volatile chemicals and Cabinets (closed) here.

>open cabinets
You hear a string snap and a loud beep before a hidden bomb destroys the entire house, now there can't be any justice!

    *** G A M E  O V E R ***

Would you like to RESTART, RESTORE a saved game, QUIT or UNDO the last command?

* * *

>take key
Taken.

A strange ticking noise fills the air

>w
(first opening main door)
It seems to be locked.

A strange ticking noise fills the air

>unlock main door
(with Entrance Key)
You unlock main door.

A strange ticking noise fills the air

>w
(first opening main door)

Entrance
The hall lies ahead to the west, the entrance sits behind you to the east

You can see main door here.

A strange ticking noise fills the air

* * *

>w
Hall 1
Another room of gateways to other rooms, the Kitchen is to the North with a garage to the South and more hallway ahead to the West

A strange ticking noise fills the air

>w
Hall 2
The room of gateways to other rooms, to the North is the Livingroom with a Bedroom to the West and more hallway behind you to the East

A strange ticking noise fills the air

>n
Livingroom
There's not much here apart from a couch and countless empty beer bottles. There's two sets of stairs, one going Down to the Basement and one going Up to the Attic

A strange ticking noise fills the air

>up
Attic
Just a small crawl space devoid of boxes

You can see Trunk key here.

A strange ticking noise fills the air

>take key
(Trunk key)
Taken.

A strange ticking noise fills the air

>down
Livingroom
There's not much here apart from a couch and countless empty beer bottles. There's two sets of stairs, one going Down to the Basement and one going Up to the Attic

A strange ticking noise fills the air

>s
Hall 2
The room of gateways to other rooms, to the North is the Livingroom with a Bedroom to the West and more hallway behind you to the East

A strange ticking noise fills the air

>e
Hall 1
Another room of gateways to other rooms, the Kitchen is to the North with a garage to the South and more hallway ahead to the West

A strange ticking noise fills the air

>s
Garage
Blank walls and sparse tools litter the room with an armored sedan sitting in the center

You can see Car here.

A strange ticking noise fills the air

>unlock car trunk
What do you want to unlock Car Trunk with?

>unlock with trunk key
You can't see any such thing.

>unlock car trunk with trunk key
You unlock Car Trunk.

A strange ticking noise fills the air

>open car trunk
You open Car Trunk, revealing a Timebomb.

A strange ticking noise fills the air

>take timebomb
Taken.

>n
Hall 1
Another room of gateways to other rooms, the Kitchen is to the North with a garage to the South and more hallway ahead to the West

>n
Kitchen
Hardly stocked and an absolute mess with all manner of bottles and rotting take out leftovers sitting around

You can see Cabinets (closed) and Scratched Tile (closed) here.

>open hidden compartment
You can't see any such thing.

>open scratched tile
You open Scratched Tile, revealing hidden compartment.

>open hidden compartment
That's already open.

>s
Hall 1
Another room of gateways to other rooms, the Kitchen is to the North with a garage to the South and more hallway ahead to the West

>e
Entrance
The hall lies ahead to the west, the entrance sits behind you to the east

You can see main door here.

>e
Front Lawn
No point standing out here, time to kick the door in and search the building for evidence!

You can see main door and a Fake Rock (empty) here.

>w
Entrance
The hall lies ahead to the west, the entrance sits behind you to the east

You can see main door here.

>w
Hall 1
Another room of gateways to other rooms, the Kitchen is to the North with a garage to the South and more hallway ahead to the West

* * *

>s
Bathroom
You have to cover your nose to even remotely stand being in this room, tiles fall off the walls as mold and who knows what else covers the floor

You can see a Toilet here.

>open toilet tank
It isn't something you can open.

>x toilet
(the Toilet)
The toilet has a tank on it and a lid covering its bowl

>open toilet tank
It isn't something you can open.

>x toilet tank
In toilet tank is cocaine.

>take cocaine
Taken.

* * *

>n
Livingroom
There's not much here apart from a couch and countless empty beer bottles. There's two sets of stairs, one going Down to the Basement and one going Up to the Attic

>down
Basement
They seem intent on killing you and fleeing the law

>attack convict
You attack Convict, causing 31 points of damage!

Convict attacks you, causing 21 points of damage!

>attack convict
You attack Convict, causing 35 points of damage!

Convict attacks you, causing 11 points of damage!

>attack convict
You attack Convict, causing 44 points of damage!

Convict lies on the ground dead

>up
Livingroom
There's not much here apart from a couch and countless empty beer bottles. There's two sets of stairs, one going Down to the Basement and one going Up to the Attic

>down
Basement
Yep, they're dead. maybe they were hiding something on their person?

>x convicts corpse
You can't see any such thing.

>x convict
You can't see any such thing.

>x convicts body
You see nothing special about Convicts Body.

* * *

You're a rookie cop whos been assigned to raid a criminals stash house for evidence of their crimes. You're looking for A Bomb they built, Volatile chemicals they were planning to mix, a Fake ID they were going to use to escape, and a bag of Cocaine they were stashing. Find all the evidence and bring the criminal to justice!

BEAT COP
An Interactive Fiction by Logan Williamson
Release 1 / Serial number 251008 / Inform 7 v10.1.2 / D

Front Lawn
No point standing out here, time to kick the door in and search the building for evidence!

You can see main door and a Fake Rock (closed) here.

>s
Bathroom
Take a shit and leave

You can see toilet here.

>examine toilet
(toilet)
The toilet has a tank on it and a lid covering its bowl

>x toilet tank
In toilet tank is cocaine.

* * *

>take cocaine
Taken.

>x cocaine
You see nothing special about cocaine.

* * *

>s
Bathroom
Take a shit and leave

You can see toilet here.

>inspect toilet
That's not a verb I recognise.

>x toilet
You can't see any such thing.

* * *

>s
Bathroom
Take a shit and leave

You can see toilet here.

>punch toilet
Violence isn't the answer to this one.

>sit on toilet
That's not something you can sit down on.

* * *

>s
Bathroom
Take a shit and leave

You can see toilet here.

>x toilet
(toilet)
You see nothing special about toilet.

>x toilet tank
In toilet tank is cocaine.

* * *

>x cocaine
You see nothing special about cocaine.

>eat cocaine
What are you, a filthy drug addict?

* * *

>s
Bathroom
Take a shit and leave

You can see toilet here.

>x toilet tank
You can't see any such thing.

* * *

You're a rookie cop whos been assigned to raid a criminals stash house for evidence of their crimes. You're looking for A Bomb they built, Volatile chemicals they were planning to mix, a Fake ID they were going to use to escape, and a bag of Cocaine they were stashing. Find all the evidence and bring the criminal to justice!

BEAT COP
An Interactive Fiction by Logan Williamson
Release 1 / Serial number 251008 / Inform 7 v10.1.2 / D

Front Lawn
No point standing out here, time to kick the door in and search the building for evidence!

You can see main door and a Fake Rock (closed) here.

>take key
You can't see any such thing.

>x rock
You see nothing special about the Fake Rock.

>open rock
You open the Fake Rock, revealing Entrance Key.

>take key
Taken.

>unlock door
(with Entrance Key)
You unlock main door.

>w
(first opening main door)

Entrance
You can see main door here.

* * *

>w
Hall 1
Another room of gateways to other rooms, the Kitchen is to the North with a garage to the South and more hallway ahead to the West

I beg your pardon?

>w
Hall 2
The room of gateways to other rooms, to the North is the Livingroom with a Bedroom to the West and more hallway behind you to the East

* * *

>s
Garage
You can see Car here.

>x car
There's nothing on the car's seats, but there is a trunk that you haven't checked

>x trunk
(Trunk key)
You see nothing special about Trunk key.

* * *

You're a rookie cop whos been assigned to raid a criminals stash house for evidence of their crimes. You're looking for A Bomb they built, Volatile chemicals they were planning to mix, a Fake ID they were going to use to escape, and a bag of Cocaine they were stashing. Find all the evidence and bring the criminal to justice!

BEAT COP
An Interactive Fiction by Logan Williamson
Release 1 / Serial number 251008 / Inform 7 v10.1.2 / D

Front Lawn
No point standing out here, time to kick the door in and search the building for evidence!

You can see main door and a Fake Rock (closed) here.

>take rock
That's fixed in place.

>open rock
You open the Fake Rock, revealing Entrance Key.

>take
What do you want to take?

* * *

You're a rookie cop whos been assigned to raid a criminals stash house for evidence of their crimes. You're looking for A Bomb they built, Volatile chemicals they were planning to mix, a Fake ID they were going to use to escape, and a bag of Cocaine they were stashing. Find all the evidence and bring the criminal to justice!

BEAT COP
An Interactive Fiction by Logan Williamson
Release 1 / Serial number 251008 / Inform 7 v10.1.2 / D

Front Lawn
No point standing out here, time to kick the door in and search the building for evidence!

You can see main door and a Fake Rock (closed) here.

>w
(first opening main door)
It seems to be locked.

>s
You can't go that way.

* * *

>s
Garage
You can see Car here.

>x trunk
strange it was left unlocked, theres an unarmed bomb inside

>take
(Car)
You're not superman dumbass.

>take bomb
Taken.

>n
Hall 1
Another room of gateways to other rooms, the Kitchen is to the North with a garage to the South and more hallway ahead to the West

* * *

>w
Hall 2
The room of gateways to other rooms, to the North is the Livingroom with a Bedroom to the West and more hallway behind you to the East

>s
You can't go that way.

>w
Bedroom
It's a bedroom, you're either sleeping or leaving. The bedroom looks to be in shambles with only a Closet, Dresser, and Nightstand being noteworthy enough to search. There's a bathroom to the South with the Closet being to the North

You can see Rifle here.

>take
(Rifle)
Taken.

>s
Bathroom
You have to cover your nose to even remotely stand being in this room, tiles fall off the walls as mold and who knows what else covers the floor

You can see a Toilet here.

>x tank
In toilet tank is cocaine.

>take
(the Toilet)
why.

* * *

>take cocaine
Taken.

>n
Bedroom
It's a bedroom, you're either sleeping or leaving. The bedroom looks to be in shambles with only a Closet, Dresser, and Nightstand being noteworthy enough to search. There's a bathroom to the South with the Closet being to the North

>n
Closet
You can see Cord 1, Cord 2 and Cardboard Box (in which is Fake ID) here.

>tkae fake ID
That's not a verb I recognise.

>Take Fake ID
Taken.

You found all the evidence! Now the criminal can face justice. !!YOU WIN!! G A M E  O V E R.

* * *

>w
(first opening main door)
It seems to be locked.

>w
(first opening main door)
It seems to be locked.

>examine main door
(main door)
 The criminal must have locked the door behind them! There might be a key around to get in though.

>x main door
(main door)
 The criminal must have locked the door behind them! There might be a key around to get in though.

>x fake rock
In Fake Rock is Main Door Key.

>take
What do you want to take?

>door key
Taken.

>use door key on main door
That's not a verb I recognise.

>unlock main door
(Main Door Key with Main Door Key)
That doesn't seem to be something you can unlock.

>kick main door
(Main Door Key)
Main Door Key is not something you can kick.

>kick door
(Main Door Key)
Main Door Key is not something you can kick.

>kick Door
(Main Door Key)
Main Door Key is not something you can kick.

>drop key
Dropped.

>kick door
Which do you mean, Main Door Key or main door?

>kick main door
Which do you mean, Main Door Key or main door?

* * *

>w
(first opening main door)
It seems to be locked.

>n
Kitchen
You can see Volatile chemicals here.

* * *

>s
You can't go that way.

>e
You can't go that way.

>s
You can't go that way.

* * *

>s
Garage
You can see Car here.

>open trunk
(Trunk key)
It isn't something you can open.

* * *

>n
Kitchen
You can see Volatile chemicals here.

>take chemicals
Taken.

>s
Hall 1
Another room of gateways to other rooms, the Kitchen is to the North with a garage to the South and more hallway ahead to the West

* * *

>s
Garage
You can see Car here.

>x trunk
You see nothing special about Trunk.

* * *

>w
(first opening main door)
It seems to be locked.

>s
Garage
You can see Car here.

>take
(Car)
You're not superman dumbass.

>i
You are carrying nothing.

>take Fake ID
You can't see any such thing.

>x trunk
strange it was left unlocked, theres an unarmed bomb inside

>take bomb
You can't see any such thing.

* * *

>x car
There's nothing on the car's seats, but there is a trunk that you haven't checked

>x trunk
strange it was left unlocked, theres an unarmed bomb inside

>n
Hall 1
Another room of gateways to other rooms, the Kitchen is to the North with a garage to the South and more hallway ahead to the West

* * *

>n
Livingroom
There's not much here apart from a couch and countless empty beer bottles. There's two sets of stairs, one going Down to the Basement and one going Up to the Attic

>go up
Attic
You can see Trunk key here.

>take trunk key
Taken.

>s
You can't go that way.

* * *

>s
Hall 2
The room of gateways to other rooms, to the North is the Livingroom with a Bedroom to the West and more hallway behind you to the East

>w
Bedroom
It's a bedroom, you're either sleeping or leaving. The bedroom looks to be in shambles with only a Closet, Dresser, and Nightstand being noteworthy enough to search. There's a bathroom to the South with the Closet being to the North

You can see Rifle here.

* * *

>s
Bathroom
You have to cover your nose to even remotely stand being in this room, tiles fall off the walls as mold and who knows what else covers the floor

You can see a Toilet here.

>x toilet tank
There's nothing on the car's seats, but htere is a trunk that you haven't checked
In toilet tank is cocaine.

>take cocaine
Taken.

* * *

>n
Bedroom
It's a bedroom, you're either sleeping or leaving. The bedroom looks to be in shambles with only a Closet, Dresser, and Nightstand being noteworthy enough to search. There's a bathroom to the South with the Closet being to the North

You can see Rifle here.

>inventory
You are carrying:
  cocaine
  Trunk key

>e
Hall 2
The room of gateways to other rooms, to the North is the Livingroom with a Bedroom to the West and more hallway behind you to the East

* * *

>n
Livingroom
There's not much here apart from a couch and countless empty beer bottles. There's two sets of stairs, one going Down to the Basement and one going Up to the Attic

>s
Hall 2
The room of gateways to other rooms, to the North is the Livingroom with a Bedroom to the West and more hallway behind you to the East

* * *

>e
Hall 1
Another room of gateways to other rooms, the Kitchen is to the North with a garage to the South and more hallway ahead to the West

>n
Kitchen
You can see Volatile chemicals here.

* * *

>s
Garage
You can see Car here.

>use trunk key on trunk
That's not a verb I recognise.

>Use trunk key
That's not a verb I recognise.

>open trunk
(Trunk key)
It isn't something you can open.

* * *

>s
Hall 1
Another room of gateways to other rooms, the Kitchen is to the North with a garage to the South and more hallway ahead to the West

>e
Entrance

>w
Hall 1
Another room of gateways to other rooms, the Kitchen is to the North with a garage to the South and more hallway ahead to the West

* * *

>x tank
In toilet tank is cocaine.

>take
(the Toilet)
Taken.

* * *

>x trunk
strange it was left unlocked, theres an unarmed bomb inside

>take bomb
Taken.

* * *

>take
(Volatile chemicals)
Taken.

>w
You can't go that way.

>w
You can't go that way.

>s
Hall 1
Another room of gateways to other rooms, the Kitchen is to the North with a garage to the South and more hallway ahead to the West

* * *

>x tank
In toilet tank is cocaine.

>take cocaine
Taken.

* * *

>n
Bedroom
It's a bedroom, you're either sleeping or leaving. The bedroom looks to be in shambles with only a Closet, Dresser, and Nightstand being noteworthy enough to search. There's a bathroom to the South with the Closet being to the North

You can see Rifle here.

>n
Closet
You can see Cord 1, Cord 2 and Cardboard Box (in which is Fake ID) here.

>take Fake ID
Taken.

    *** You found all the evidence! Now the criminal can face justice. !!YOU WIN!! G A M E  O V E R. ***

Would you like to RESTART, RESTORE a saved game, QUIT or UNDO the last command?

* * *

>take bomb
Taken.

>open trunk
It seems to be locked.

* * *

>n
Kitchen
You can see Volatile chemicals here.

>s
Hall 1
Another room of gateways to other rooms, the Kitchen is to the North with a garage to the South and more hallway ahead to the West

* * *

>n
Livingroom
There's not much here apart from a couch and countless empty beer bottles. There's two sets of stairs, one going Down to the Basement and one going Up to the Attic

>u
Attic
You can see Trunk key here.

>take
(Trunk key)
Taken.

>d
Livingroom
There's not much here apart from a couch and countless empty beer bottles. There's two sets of stairs, one going Down to the Basement and one going Up to the Attic

>s
Hall 2
The room of gateways to other rooms, to the North is the Livingroom with a Bedroom to the West and more hallway behind you to the East

* * *

>x trunk
(Trunk key)
You see nothing special about Trunk key.

>open trunk
(Trunk key)
It isn't something you can open.

* * *

>take bomb
Taken.

>take Bomb
You can't see any such thing.

>Take trunk
That seems to be a part of Car.

* * *

>w
(first opening main door)
It seems to be locked.

>w
Hall 2
The room of gateways to other rooms, to the North is the Livingroom with a Bedroom to the West and more hallway behind you to the East

* * *

>n
Livingroom
There's not much here apart from a couch and countless empty beer bottles. There's two sets of stairs, one going Down to the Basement and one going Up to the Attic

>d
Basement
You can see Convict 1 here.

>attack
(Convict 1)
You attack Convict 1, causing 22 points of damage!

Convict 1 attacks you, causing 29 points of damage!

>attack
(Convict 1)
You attack Convict 1, causing 38 points of damage!

Convict 1 attacks you, causing 19 points of damage!

>attack
(Convict 1)
You attack Convict 1, causing 36 points of damage!

Convict 1 attacks you, causing 28 points of damage!

>attack
(Convict 1)
You attack Convict 1, causing 28 points of damage!

Convict 1 lies on the ground dead

* * *

>attack
(Convict 1)
You attack Convict 1, causing 36 points of damage!

Convict 1 attacks you, causing 28 points of damage!

>u
Livingroom
There's not much here apart from a couch and countless empty beer bottles. There's two sets of stairs, one going Down to the Basement and one going Up to the Attic

* * *

>w
Bedroom
It's a bedroom, you're either sleeping or leaving. The bedroom looks to be in shambles with only a Closet, Dresser, and Nightstand being noteworthy enough to search. There's a bathroom to the South with the Closet being to the North

You can see Rifle here.

>n
Closet
You can see Cord 1, Cord 2 and Cardboard Box (in which is Fake ID) here.

>take ID
Taken.

>s
Bedroom
It's a bedroom, you're either sleeping or leaving. The bedroom looks to be in shambles with only a Closet, Dresser, and Nightstand being noteworthy enough to search. There's a bathroom to the South with the Closet being to the North

You can see Rifle here.

>take
(Rifle)
Taken.

* * *

>s
Bathroom
You have to cover your nose to even remotely stand being in this room, tiles fall off the walls as mold and who knows what else covers the floor

You can see a Toilet here.

>x tank
There's nothing on the car's seats, but there is a trunk that you haven't checked
In toilet tank is cocaine.

>take
(the Toilet)
Taken.

>n
Bedroom
It's a bedroom, you're either sleeping or leaving. The bedroom looks to be in shambles with only a Closet, Dresser, and Nightstand being noteworthy enough to search. There's a bathroom to the South with the Closet being to the North

>e
Hall 2
The room of gateways to other rooms, to the North is the Livingroom with a Bedroom to the West and more hallway behind you to the East

>e
Hall 1
Another room of gateways to other rooms, the Kitchen is to the North with a garage to the South and more hallway ahead to the West

* * *

>s
Garage
You can see Car here.

>x car
There's nothing on the car's seats, but there is a trunk that you haven't checked
You see nothing special about Car.

>x trunk
strange it was left unlocked, theres an unarmed bomb inside
There's nothing on the car's seats, but there is a trunk that you haven't checked
You see nothing special about Trunk.

>take
(Car)
Taken.

>drop car
Dropped.

>take bomb
You can't see any such thing.

>x trunk
strange it was left unlocked, theres an unarmed bomb inside
There's nothing on the car's seats, but there is a trunk that you haven't checked
You see nothing special about Trunk.

>take bomb
You can't see any such thing.

* * *

>w
Bedroom
It's a bedroom, you're either sleeping or leaving. The bedroom looks to be in shambles with only a Closet, Dresser, and Nightstand being noteworthy enough to search. There's a bathroom to the South with the Closet being to the North

You can see Rifle here.

>n
Darkness
It is pitch dark, and you can't see a thing.

>Pull Cord 2
The light clicks on, you can see a cardboard box up on a shelf and the other cord attached to an IED

>s
Bedroom
It's a bedroom, you're either sleeping or leaving. The bedroom looks to be in shambles with only a Closet, Dresser, and Nightstand being noteworthy enough to search. There's a bathroom to the South with the Closet being to the North

You can see Rifle here.

>n
Closet
 its dark in here, you feel two cords brush against your face .

You can see Cord 1 and Cord 2 here.

* * *

>n
Darkness
It is pitch dark, and you can't see a thing.

>examine closet
You can't see any such thing.

* * *

>n
Darkness
It is pitch dark, and you can't see a thing.

>pull Cord 2
The light clicks on, you can see a cardboard box up on a shelf and the other cord attached to an IED

>s
Bedroom
It's a bedroom, you're either sleeping or leaving. The bedroom looks to be in shambles with only a Closet, Dresser, and Nightstand being noteworthy enough to search. There's a bathroom to the South with the Closet being to the North

You can see Rifle here.

* * *

>n
Darkness
It is pitch dark, and you can't see a thing.

>pull cord 1
It was a trap! The house exploded!

    *** G A M E  O V E R ***

Would you like to RESTART, RESTORE a saved game, QUIT or UNDO the last command?

* * *

>n
Darkness
It is pitch dark, and you can't see a thing.

>x Closet
You can't see any such thing.

>inventory
You are carrying nothing.

* * *

>x Closet
You can't see any such thing.

>x closet
You can't see any such thing.

>s
Bedroom
It's a bedroom, you're either sleeping or leaving. The bedroom looks to be in shambles with only a Closet, Dresser, and Nightstand being noteworthy enough to search. There's a bathroom to the South with the Closet being to the North

You can see Rifle here.

>x bedroom
You can't see any such thing.

>x Bedroom
You can't see any such thing.

* * *

>s
Bathroom
You have to cover your nose to even remotely stand being in this room, tiles fall off the walls as mold and who knows what else covers the floor

You can see a Toilet here.

>x toilet
(the Toilet)
The toilet has a tank on it and a lid covering its bowl

>remove lid
You aren't wearing toilet bowl lid.

>open lid
It isn't something you can open.

* * *

You're a rookie cop whos been assigned to raid a criminals stash house for evidence of their crimes. You're looking for A Bomb they built, Volatile chemicals they were planning to mix, a Fake ID they were going to use to escape, and a bag of Cocaine they were stashing. Find all the evidence and bring the criminal to justice!

BEAT COP
An Interactive Fiction by Logan Williamson
Release 1 / Serial number 251008 / Inform 7 v10.1.2 / D

Front Lawn
No point standing out here, time to kick the door in and search the building for evidence!

You can see main door and a Fake Rock (closed) here.

>x
What do you want to examine?

>x Front Lawn
You can't see any such thing.

* * *

You're a rookie cop whos been assigned to raid a criminals stash house for evidence of their crimes. You're looking for A Bomb they built, Volatile chemicals they were planning to mix, a Fake ID they were going to use to escape, and a bag of Cocaine they were stashing. Find all the evidence and bring the criminal to justice!

BEAT COP
An Interactive Fiction by Logan Williamson
Release 1 / Serial number 251008 / Inform 7 v10.1.2 / D

Front Lawn
No point standing out here, time to kick the door in and search the building for evidence!

You can see main door and a Fake Rock (closed) here.

>x Front Lawn
You can't see any such thing.

* * *

You're a rookie cop whos been assigned to raid a criminals stash house for evidence of their crimes. You're looking for A Bomb they built, Volatile chemicals they were planning to mix, a Fake ID they were going to use to escape, and a bag of Cocaine they were stashing. Find all the evidence and bring the criminal to justice!

BEAT COP
An Interactive Fiction by Logan Williamson
Release 1 / Serial number 251008 / Inform 7 v10.1.2 / D

Front Lawn
No point standing out here, time to kick the door in and search the building for evidence!

You can see main door and a Fake Rock (closed) here.

>x fake rock
It seems like a plastic rock made for storing a spare key

>open fake rock
You open the Fake Rock, revealing Entrance Key.

* * *

>w
(first opening main door)
It seems to be locked.

>unlock door
(with Entrance Key)
You unlock main door.

* * *

>x fake rock
It seems like a plastic rock made for storing a spare key

>open rock
You open the Fake Rock, revealing Entrance Key.

* * *

You're a rookie cop whos been assigned to raid a criminals stash house for evidence of their crimes. You're looking for A Bomb they built, Volatile chemicals they were planning to mix, a Fake ID they were going to use to escape, and a bag of Cocaine they were stashing. Find all the evidence and bring the criminal to justice!

BEAT COP
An Interactive Fiction by Logan Williamson
Release 1 / Serial number 251008 / Inform 7 v10.1.2 / D

Front Lawn
No point standing out here, time to kick the door in and search the building for evidence!

You can see main door and a Fake Rock (closed) here.

>x front lawn
You can't see any such thing.

>x Front Lawn
You can't see any such thing.

>x room
You can't see any such thing.

* * *

You're a rookie cop whos been assigned to raid a criminals stash house for evidence of their crimes. You're looking for A Bomb they built, Volatile chemicals they were planning to mix, a Fake ID they were going to use to escape, and a bag of Cocaine they were stashing. Find all the evidence and bring the criminal to justice!

BEAT COP
An Interactive Fiction by Logan Williamson
Release 1 / Serial number 251008 / Inform 7 v10.1.2 / D

Front Lawn
No point standing out here, time to kick the door in and search the building for evidence!

You can see main door and a Fake Rock (closed) here.

>x main door
thankfully you had the criminals keys from the station, It's unlocked

>w
Entrance
You can see a main door here.

>w
(first opening the main door)

Front Lawn
No point standing out here, time to kick the door in and search the building for evidence!

You can see a main door here.

>w
Entrance
You can see a main door here.

>e
Front Lawn
No point standing out here, time to kick the door in and search the building for evidence!

You can see a main door here.

* * *

You're a rookie cop whos been assigned to raid a criminals stash house for evidence of their crimes. You're looking for A Bomb they built, Volatile chemicals they were planning to mix, a Fake ID they were going to use to escape, and a bag of Cocaine they were stashing. Find all the evidence and bring the criminal to justice!

BEAT COP
An Interactive Fiction by Logan Williamson
Release 1 / Serial number 251008 / Inform 7 v10.1.2 / D

Front Lawn
No point standing out here, time to kick the door in and search the building for evidence!

You can see main door and a Fake Rock (closed) here.

>x rock
In the Fake Rock is Entrance Key.

>take
What do you want to take?

* * *

>x rock
In the Fake Rock is Entrance Key.

>take key
Taken.

>kick door
The door swings back instantly killing you

    *** G A M E  O V E R. ***

Would you like to RESTART, RESTORE a saved game, QUIT or UNDO the last command?